"","Asia.Pacific","Europe","Americas","Other","Total"
"1",1084,901,385,31,2401
"2",1280,1055,464,43,2842
"3",1645,1217,569,53,3484
"4",1711,1350,627,66,3754
"5",1889,1444,711,74,4118
"6",2294,1590,884,73,4841
"7",2502,1683,941,77,5203
"8",2663,1799,996,92,5550
"9",2891,1909,1059,108,5967
"10",3454,2069,1241,120,6884
"11",3749,1573,959,108,6389
